4 0
A A A B A
A D D D A
A E D D A
A E E D A
B C C C A
A A A A A
